x,x,x,_,x,_,x,_,x,x,x
x,x,_,x,_,x,_,x,_,x,x
x,x,_,x,_,x,_,x,_,x,x
x,_,x,_,x,_,x,_,x,_,x
x,_,x,_,x,_,x,_,x,_,x
_,x,_,x,_,x,_,x,_,x,_
_,x,_,x,_,x,_,x,_,x,_
x,_,x,_,x,_,x,_,x,_,x
x,_,x,_,x,_,x,_,x,_,x
x,x,_,x,_,x,_,x,_,x,x
x,x,_,x,_,x,_,x,_,x,x
x,x,x,_,x,_,x,_,x,x,x